00 00 00 00 00 00 00 00 
00 00 00 00 00 00 00 00 
00 00 00 00 00 00 00 00 
00 00 00 00 00 00 00 00
00 00 00 00 00 00 00 00
08 35 62 55 00 00 00 00
f8 34 62 55 00 00 00 00
e0 19 40 00 00 00 00 00
31 37 65 33 32 61 35 33
00 00 00 00 00 00 00 00
5f c3
